11 10 9 9 9 9 9 9 9 15 30 30 30 11 9 9 9 9 9 9 9 10 9 10 9 10 9 10 9 10 9 10 9 15 30 30 30
12 7 8 7 8 7 8 7 8 16 30 30 30 13 8 7 8 7 8 7 8 7 8 7 8 7 8 7 8 7 8 7 8 16 30 30 30
12 5 6 5 6 5 6 5 6 16 30 30 30 13 6 5 6 5 6 5 6 5 6 5 6 5 6 5 6 5 6 5 6 16 30 30 30
12 4 4 4 4 4 4 4 4 16 30 30 30 13 4 4 4 4 4 23 20 19 31 4 4 4 4 4 4 4 4 4 4 16 30 30 30
12 21 1 1 23 20 31 21 21 16 30 30 30 12 21 21 21 21 21 26 9 10 29 21 21 21 21 21 23 20 31 21 21 26 30 30 30
12 1 0 1 26 10 29 21 21 26 9 9 9 29 0 0 0 0 0 25 8 8 28 0 0 0 0 0 26 10 29 22 21 25 26 30 30
12 0 1 22 25 8 28 0 0 25 7 8 7 28 0 0 0 0 0 24 8 8 28 0 0 0 22 22 25 8 28 22 22 24 25 26 30
12 0 1 22 24 5 27 0 0 24 5 5 5 27 0 0 0 0 22 4 4 4 4 22 22 21 21 22 24 5 27 21 0 4 24 25 16
12 0 0 3 4 4 4 3 21 4 4 4 4 4 21 21 22 22 3 21 3 0 22 3 22 21 22 22 4 4 4 21 22 22 4 24 16
12 0 0 1 22 3 3 3 21 21 21 21 21 21 21 21 22 3 21 21 21 21 22 22 22 21 22 22 22 0 21 22 22 22 22 4 16
12 0 23 20 31 1 1 21 21 21 21 0 0 0 22 22 22 21 21 23 19 19 19 19 19 31 22 22 21 21 22 23 20 31 0 0 16
12 0 26 10 29 22 1 0 0 0 0 23 20 31 22 22 21 21 23 18 30 30 30 30 30 14 31 22 22 22 22 26 10 29 0 0 16
12 0 25 8 28 22 22 22 22 22 22 26 10 29 22 22 22 22 16 30 30 30 30 30 30 30 14 31 22 22 22 25 8 28 0 0 16
12 21 24 5 27 1 1 21 21 21 21 25 8 28 22 22 0 22 16 30 30 30 30 30 30 30 30 14 31 22 22 24 5 27 0 0 16
12 0 4 4 4 21 21 21 21 21 21 24 5 27 3 21 22 22 16 30 30 30 30 30 30 30 30 30 13 0 0 4 4 4 0 0 16
12 0 1 0 3 2 1 1 0 2 3 3 2 1 0 0 1 2 16 30 30 30 30 30 30 30 30 30 13 2 1 3 1 1 2 3 16
14 19 20 19 20 19 20 19 20 19 20 19 20 19 20 19 20 19 18 30 30 30 30 30 30 30 30 30 14 19 20 19 20 19 19 20 18
30 30 30 30 30 30 30 30 30 30 30 30 30 30 30 30 30 30 30 30 30 30 30 30 30 30 30 30 30 30 30 30 30 30 30 30 30
