11 10 9 9 9 9 9 9 9 15 30 30 30 11 9 9 9 9 9 9 9 10 9 10 9 10 9 10 9 10 9 10 9 10 9 10 15
12 7 8 7 8 7 8 7 8 16 30 30 30 13 8 7 8 7 8 7 8 7 8 7 8 7 8 7 8 7 8 7 8 7 7 8 16
12 5 6 5 6 5 6 5 6 16 30 30 30 13 6 5 6 5 6 5 6 5 6 5 6 5 6 5 6 5 6 5 6 5 5 6 16
12 4 4 4 4 4 4 4 4 16 30 30 30 13 4 4 4 4 4 4 4 4 4 4 4 4 4 4 4 4 4 4 4 4 4 4 16
12 21 1 1 1 21 21 21 21 16 30 30 30 12 21 21 21 21 21 21 21 21 21 21 21 21 21 21 21 21 21 21 21 21 21 21 16
12 1 0 1 1 22 0 0 0 26 9 9 9 29 0 0 0 0 0 0 0 21 21 0 0 0 0 0 22 22 22 22 21 0 0 0 16
12 0 1 22 22 22 0 0 0 25 7 8 7 28 0 0 0 0 0 22 21 21 21 0 0 0 22 22 22 0 0 22 22 22 0 0 16
12 0 1 22 22 0 0 0 0 24 5 5 5 27 0 0 0 0 22 22 21 21 22 22 22 21 21 22 22 22 22 21 0 22 0 0 16
12 0 0 22 22 22 0 0 21 4 4 4 4 4 21 21 22 22 3 21 21 0 22 3 22 21 22 22 22 21 0 21 22 22 22 0 16
12 0 0 1 22 0 21 0 21 21 21 21 21 21 21 21 22 3 21 21 21 21 22 22 22 21 22 22 22 0 21 22 22 22 22 0 16
12 0 0 1 22 1 1 21 21 20 19 0 0 0 22 22 22 21 21 21 21 21 21 21 22 21 22 22 21 21 22 22 0 22 0 0 16
12 0 21 1 22 22 1 0 0 0 0 22 22 22 22 22 21 21 21 21 22 21 21 21 22 22 22 22 22 22 22 0 22 22 0 0 16
12 0 1 22 22 22 22 22 22 22 22 21 22 22 22 22 22 22 22 22 22 21 21 3 22 21 22 22 22 22 22 22 0 0 0 0 16
12 21 1 1 1 1 1 21 21 21 21 21 21 22 22 22 0 22 22 22 22 21 22 22 0 22 22 22 22 22 22 0 0 0 0 0 16
12 0 1 1 1 21 21 21 21 21 21 22 22 22 3 21 22 22 22 22 22 22 22 22 0 0 0 0 0 0 0 0 0 0 0 0 16
12 0 1 1 1 0 0 0 0 0 0 0 0 3 0 0 22 22 0 0 0 0 3 0 0 0 0 0 0 0 0 0 0 0 0 0 16
12 0 0 0 0 0 0 0 0 0 0 0 0 0 0 0 0 0 0 0 0 0 0 0 0 0 0 0 0 0 0 0 0 0 0 0 16
30 19 19 19 19 19 19 19 19 19 19 19 19 19 19 19 19 19 19 19 19 19 19 19 19 19 19 19 19 19 19 19 19 19 19 19 18
